920
####################################################################################################
#*     * *        * *     *  *             *             *  *    *     *      *   *          *     #
#  *     ### ###    * *  **   ****  *                   ### *    *               *     #####       #
#        ###*### #* *      *  *     * * * *             ###* *    * *   *  *  C *        #*   ## * #
# *   *  ###I### #                     *    *     >     ###        *          *   *      #   ##*   #
#    # # ### ### ### # #*     ##### #  *  *    *   # #**### #  ###    #   # #   *  ###           # #
# ##*#*#*###*### # * # ## *     #   ## ##  #*  ## ## ## ### ## * # ## #  *# ## *  *#*    ### ## ## #
# ## # # ###*### #  *#  #*###   #    #*## ###*##  #   # ###  #  *# ## # ### *# ### #*###  #  ## #  #
#           **      *  *                * *        **               *    *   *    *   ** *         #
####################################################################################################
