284
####################
#  **        *     #
#  *    *          #
#     *      *     #
# ###          *#* #
#        *     ##  #
# #####   * ** # * #
#*  #   **#  #  B  #
#   # *   ##P#  #  #
#*   C* *  # # ### #
#    *# # >  ** *  #
# *#  # #  *## *#  #
# ### # ### ## ### #
#           *      #
####################
