252
###############
#*  * *    * *#
#*  ### *   # #
# #     *   # #
#*##I###P*# # #
#  # *#  ##*B #
#  *     #  # #
#  *# >   * # #
#   #   # ### #
# ###*  #  *# #
#  *# ###   # #
#   # **      #
#     ######  #
# #*  ###### *#
# # *C######* #
# ###        *#
# # ** # *    #
# #   ###     #
#            *#
###############
