279
####################
# *   **        *  #
#*        *     *  #
#       * * ### #  #
#  *   B      # ## #
#      C      #  # #
#   * #####    I   #
#  ##* *#  *##**##*#
# ##  * #    ##*## #
#  *  ** P         #
# >  # *  #  ### * #
#*## # ## ##   #   #
# ## # ## #    # * #
#  *   *      * *  #
####################
