309
#########
#       #
#*  #   #
#   # * #
#*###   #
#       #
# ###P  #
#  #    #
#   * # #
#  ##*# #
#*##  # #
#       #
#*  ### #
# #*    #
#*## *  #
# #   **#
#  * * *#
#   ###*#
#*  >#  #
# # * * #
# ## ## #
# #* ## #
#** * **#
# *##*  #
# ## *  #
#      *#
#   ## *#
#   ## *#
# # * B #
# ## #  #
#  #*## #
#   **# #
# ##*   #
#  ##   #
#       #
# ###   #
# #     #
# #     #
#      *#
#########
