80
##########
#      * #
# >    #P#
#   ** # #
# *    # #
# *#*#   #
#*## ## *#
#  # #   #
#    *   #
##########
