20
#########
#   * I #
# ### * #
#     * #
# #   #*#
# ## ## #
#  #  # #
#>    C #
#########
