308
#########################
#  *  **      **  * *   #
#*     **            #* #
#  *    *   ######*  #  #
#     #    *######*###  #
#     #     ######      #
#     ### #    C * # *I #
# ### #  *#   ###  #  * #
#P### #   ###  # * # #  #
# ### *     >     B *##*#
#*###   # ######   #  # #
# ###   # ###### * #*   #
# ### ### ###### ##### *#
#           *          *#
#########################
