80
########################################
#                  *   *    **   *     #
#     *             C        *    * * *#
#**                            *## ##* #
#      ***   *   * >  *   *    *##* ## #
# ######   *   * * #    *###* #  *     #
# ######*##  B   * #* ## # * ##  ##*##*#
# ######  ## ### ###*##  #   #* ## I## #
# *   *        * *   *  * P       *  **#
########################################
