819
##########################################################################################
# *    * *      *   *           *          * **        * **             **  *    ****  * #
#*               ### ### ### ###       * *  * *           *                *    *   **  *#
#**  ***         ###*### ### ###        ** #       * *   *         *  ** * *         * # #
#* *  *  **B  * *###*###P### ###  *       *#* *    >        *     *       *      **  * #*#
# **   *  #  *#  ### ### ### ###* #  #     ###*        #   *#     # ###   ** *#** #  ### #
#  ##     # * ## ### ### ### ### ##*##  #* #    ##   * #   ##*## ## #    ##   #   ##   # #
# ##  ### ###*# *### ### ### ### #* #  ###*#   ## *### ### #  ## #  #   ##  ##### *#*  #*#
# *   *   *   *    *           * *     *    *   *       *    **             * *     *    #
##########################################################################################
