500
###################
#*****    C#**I P*#
#**#      @#***#**#
#**#########***#**#
#**#*******#>**#**#
#** ******B#####**#
#** *******#@   **#
###################