423
##############################
#       *     *  *       *  *#
#          *           **    #
#       ##     ##   * >*     #
# #   # ##**  ##  *        # #
#*## ##   P #      * B     # #
#* # #  #  ### #*   *  ### #*#
#  *    #**    ## ## #       #
# ###   ###     # ## #  I ## #
#*  #    * *  C * ** ### ##  #
#*  #  #   *   #*  # *       #
#   **## ##  * #   # ##*##   #
# ### #   ## ##### # ## ## * #
#      *      *     *     *  #
##############################
