204
##########
#* *     #
# ##  ## #
#  ## ## #
#* **  * #
# ## ##  #
# ## ##* #
# *  B   #
# ###### #
# ###### #
#*######*#
#   C   *#
#  #   * #
# ##*    #
# #     *#
#   *    #
#*#####  #
#   #    #
#** #    #
#        #
#*#  *   #
# #      #
# #  *  *#
#*  > ** #
##########
